{"":"sil",
    "k":"k",
    "p":"p",
    "r":"r",
    "f":"f",
    "@":"@",
    "a":"a",
    "e":"e",
    "i":"i",
    "o":"o",
    "O":"0",
    "u": "u",
    "E":"EE",
    "t":"t",
    "T":"TT", 
    "s":"s" ,
    "S":"SS"}